am	be
are	be
arose	arise
ate	eat
awoke	awake
awoken	awake
bade	bid
became	become
been	be
befell	befall
began	begin
begat	beget
begotten	beget
begotton	beget
begun	begin
bent	bend
besought	beseech
bespake	bespeak
bespoke	bespeak
bespoken	bespeak
best	good
bethought	bethink
betook	betake
better	good
bitten	bite
bled	bled
blent	blend
blest	bless
blew	blow
blown	blow
bore	bear
borne	bear
bought	buy
bound	bind
bred	breed
broke	break
broken	break
brought	bring
built	build
came	come
caught	catch
children	child
chose	choose
chosen	choose
cleft	cleave
clove	cleave
cloven	cleave
clung	cling
could	can
crept	creep
curst	curse
dealt	deal
did	do
dipt	dip
done	do
dove	dive
drank	drink
drawn	draw
drew	draw
dript	drip
dropt	drop
drove	drive
drunk	drink
dug	dig
durst	dare
dwelt	dwell
eaten	eat
fallen	fall
fed	feed
fell	fall
felt	feel
fled	flee
flew	fly
flown	fly
flung	fling
forbad	forbid
forbade	forbid
forbidden	forbid
forbore	forbear
forborne	forbear
fordone	fordo
foregone	forego
foretold	foretell
forewent	forego
forgave	forgive
forgiven	forgive
forgot	forget
forgotten	forget
forsook	forsake
forwent	forego
fought	fight
found	find
froze	freeze
frozen	freeze
gae	give
gave	give
girt	gird
given	give
gone	go
got	get
gotten	get
grew	grow
ground	grind
had	have
hadst	have
has	have
he	one
held	hold
her	one's
hid	hide
hidden	hide
him	one
his	one's
hove	heave
hung	hang
i	I	one
interwoven	interweave
is	be
its	one's
itself	oneself
kept	keep
knelt	kneel
knew	know
laid	lay
lain	lie
leant	lean
leapt	leap
learnt	learn
led	lead
left	leave
lent	lend
lit	light
made	make
me	one
meant	mean
met	meet
methought	methinks
might	may
misled	mislead
mistook	mistake
molten	melt
my	one's
nam	nim
one	us
our	one's
overbuilt	overbuild
overcame	overcome
overslept	oversleep
overthrew	overthrow
paid	pay
partook	partake
pled	plead
prepaid	prepay
ran	run
rang	ring
reft	reave
relaid	relay
repaid	repay
rethought	rethink
ridden	ride
rode	ride
rose	rise
rung	ring
said	say
sang	sing
sank	sink
sat	sit
saw	see
sent	send
shat	shit
she	one
shod	shoe
shodden	shoe
shone	shine
shook	shake
shorn	shear
shot	shoot
shrank	shrink
shrove	shrive
shrunk	shrink
shrunken	shrink
slain	slay
slept	sleep
slew	slay
slid	slide
slidden	slide
slipt	slip
slung	sling
slunk	slink
smit	smite
smitten	smite
smote	smite
snuck	sneak
sold	sell
sought	seek
spake	speak
spat	spit
sped	speed
spelt	spell
spent	spend
spilt	spill
spoilt	spoil
spoke	speak
spoken	speak
sprang	spring
sprung	spring
spun	spin
stang	sting
stank	stink
stole	steal
stolen	steal
stood	stand
stridden	stride
strode	stride
strove	strive
struck	strike
strung	string
stuck	stick
stung	sting
stunk	stink
submersion	submergence
sung	sing
sunk	sink
swam	swim
swang	swing
swank	swink
sware	swear
swept	sweep
swollen	swell
swore	swear
sworn	swear
swum	swim
swung	swing
taught	teach
their	one's
them	one
they	one
thought	think
threw	throw
throve	thrive
told	tell
took	take
tore	tear
torn	tear
tost	toss
trod	tread
trodden	tread
undergone	undergo
underlaid	underlay
understood	understand
undertaken	undertake
undertook	undertake
underwent	undergo
undid	undo
undone	undo
upheld	uphold
uprose	uprise
us	one
was	be
we	one
went	go
wept	weep
were	be
withdrew	withdraw
withheld	withhold
withstood	withstand
woke	wake
woken	wake
won	win
wore	wear
worn	wear
worse	bad
worst	bad
would	will
wove	weave
woven	weave
wrapt	wrap
written	write
wrote	write
wrung	wring
you	one
your	one's